,,,,,,,,,,,,,,,,,,,,,
,,,,,,,,,,,,,,,,,,,,,
,,,<_____________>,,,
,,,[#%#%#%#%#%#%#],,,
,,,[......@......],,,
,,,[.............],,,
,,,[.............],,,
,,,[.............],,,
,,,[.............],,,
,,,[.............],,,
,,,{_____________},,,
,,,###############,,,
,,,,,,,,,,,,,,,,,,,,,
,,,,,,,,,,,,,,,,,,,,,