<___________________>
[###%#%#%#%#%#%#%###]
[................BBB]
[...................]
[...................]
[...h..h..h..h...h..]
[..hH.H.H.H.H.H.H.h.]
[...h..h..h..h...h..]
[.........@.........]
[BB.................]
[hL.................]
[...................]
{___________________}
#####################