<___________________>
[#####%##%##%##%####]
[..@............bBcB]
<................xxx]
[B].<_........_>....]
[B].[#...][...#]xxxx]
[B].[Booo][oooB].k.x]
[B].[B...][...B]...x]
[B].[B...}{...B].hhx]
[B].[bbcc##ccbb]hH.h]
[B].{__________}.hh.]
[B].##%#%#%#%#%#....]
{_}D{__________}____}
###r#################