#####################
#@..................#
#...................#
#...................#
#...................#
#...h...h...h...h...#
#...HHHHHHHHHHHHH...#
#...h...h...h...h...#
#...................#
#...................#
#...................#
#...................#
#...................#
#####################