<___________________>
[###%#%#%#%#%#%#####]
[.............[.xBcB]
[..........e..{.xxkx]
[.............#..xxx]
[...................]
[.....h.h.h.h.h.....]
[....hH.H.H.H.h.....]
[.....h.h.h.h.h.....]
[.....@.............]
[cBB.......E........]
[chL................]
{_______________D___}
################r####