<___________________>
[###%#%#%#%#%#%#####]
[...B.B.b.B.b.[xxBcB]
[.............{.xxkx]
[.............#..xxx]
[...................]
[.....h.h.h.h.h.....]
[....hH.H.H.H.h.....]
[.....h.h.h.h.h.....]
[.....@.............]
[cBB..........<_.>oo]
[chL..........[#D]ob]
{_____________[.r]__}
#####################