<___________________>
[###################]
[[BBccB]________}Bkb]
[[ooohL]#########xxx]
[{__o__}.b.b.b.b....]
[%#%x%#%............]
[...............e.[.]
[@.o..o..o..o..o..[r]
[......e..........{_}
[<________.___>...#%#
[[########D###].....]
[[b.b.bcxxxxxc].....]
{[xcxcxxxoxoxc]_____}
#####################