<___________________>
#####################
[...................]
[...................]
[...................]
[...................]
[@..................]
[...................]
[...................]
[...................]
[...................]
[...................]
{___________________}
#####################